##---- normexp ----##
normexp_sub_directories_core	true:core:directory	none

normexp_file_matrix_annotated	true:core:file	none
normexp_file_matrix_IDs	true:core:file	none
normexp_file_matrix_symbols	true:core:file	none
normexp_file_gene_IDs	true:core:file	none
normexp_file_gene_symbols	true:core:file	none
normexp_deciles	true:core:file	none
normexp_quartiles	true:core:file	none

normexp_start_plots	true:plot_core:core	none
normexp_plot_distribution_of_expression_values	true:plot:optional	normexp/plots/normexp_distribution_of_expression_values.txt
normexp_plot_PCA_contribution_of_components	true:plot:optional	normexp/plots/normexp_PCA_contributions_of_components.txt
normexp_plot_PCA_scatterplot	true:plot:optional	normexp/plots/normexp_PCA_scatterplot.txt
normexp_plot_correlation_analysis_heatmap	true:plot:optional	normexp/plots/normexp_correlation_analysis_heatmap.txt
normexp_plot_most_expressed_genes_tables	true:plot:optional	normexp/plots/normexp_most_expressed_genes_tables.txt
normexp_plot_most_expressed_genes_violin_plots	true:plot:optional	normexp/plots/normexp_most_expressed_genes_violin_plots.txt
normexp_end_plots	true:plot_core:core	none
normexp_run_r	true:plot_core:core	none

normexp_start_report	true:report_core:core	none
normexp_report_expression	true:report_title:optional	Expression
normexp_report_distribution_of_expression_values	true:report_plot:optional	normexp/report/normexp_distribution_of_expression_values.txt
normexp_report_PCA_contribution_of_components	true:report_plot:optional	normexp/report/normexp_PCA_contributions_of_components.txt
normexp_report_PCA_scatterplot	true:report_plot:optional	normexp/report/normexp_PCA_scatterplot.txt
normexp_report_correlation_analysis_heatmap	true:report_plot:optional	normexp/report/normexp_correlation_analysis_heatmap.txt
normexp_report_most_expressed_genes_tables	true:report_plot:optional	normexp/report/normexp_most_expressed_genes_tables.txt
normexp_report_most_expressed_genes_violin_plots	true:report_plot:optional	normexp/report/normexp_most_expressed_genes_violin_plots.txt
normexp_report_methodology	true:report_title:optional	Methodology
normexp_report_core_workflow_methods	true:report_text:optional	methods/normexp/core_workflow.txt
normexp_report_extras	true:report_title:optional	Extras
normexp_report_citation	true:report_text:optional	citation.txt
normexp_end_report	true:report_core:core	none


##---- pde ----##
pde_sub_directories_core	true:core:directory	none

pde_file_gene_IDs	true:core:file	none
pde_file_gene_IDs_upregulated	true:core:file	none
pde_file_gene_IDs_downregulated	true:core:file	none
pde_file_gene_IDs_significant	true:core:file	none
pde_file_gene_IDs_significant_upregulated	true:core:file	none
pde_file_gene_IDs_significant_downregulated	true:core:file	none
pde_file_gene_symbols	true:core:file	none
pde_file_gene_symbols_upregulated	true:core:file	none
pde_file_gene_symbols_downregulated	true:core:file	none
pde_file_gene_symbols_significant	true:core:file	none
pde_file_gene_symbols_significant_upregulated	true:core:file	none
pde_file_gene_symbols_significant_downregulated	true:core:file	none
pde_file_annotated	true:core:file	none
pde_file_annotated_upregulated	true:core:file	none
pde_file_annotated_downregulated	true:core:file	none
pde_file_annotated_significant	true:core:file	none
pde_file_annotated_significant_upregulated	true:core:file	none
pde_file_annotated_significant_downregulated	true:core:file	none

pde_analysis_spatial	true:statistical:spatial	none
pde_analysis_hypergeometric_gene_sets	true:statistical:hypergeometric_gene_set	none
pde_analysis_ipa_upstream_regulators	true:statistical:ipa_ureg	none

pde_start_plots	true:plot_core:core	none
pde_plot_distribution_of_expression_values	true:plot:optional	pde/plots/pde_distribution_of_expression_values.txt
pde_plot_PCA_contribution_of_components	true:plot:optional	pde/plots/pde_PCA_contributions_of_components.txt
pde_plot_PCA_scatterplot	true:plot:optional	pde/plots/pde_PCA_scatterplot.txt
pde_plot_correlation_analysis_heatmap	true:plot:optional	pde/plots/pde_correlation_analysis_heatmap.txt
pde_plot_most_expressed_genes_tables	true:plot:optional	pde/plots/pde_most_expressed_genes_tables.txt
pde_plot_most_expressed_genes_violin_plots	true:plot:optional	pde/plots/pde_most_expressed_genes_violin_plots.txt
pde_plot_volcano_plot	true:plot:optional	pde/plots/pde_volcano_plot.txt
pde_plot_MA_plot	true:plot:optional	pde/plots/pde_MA_plot.txt
pde_plot_number_of_significant_genes	true:plot:optional	pde/plots/pde_number_of_significant_genes.txt
pde_plot_significant_genes_heatmap	true:plot:optional	pde/plots/pde_significant_genes_heatmap.txt
pde_plot_most_differential_genes_tables	true:plot:optional	pde/plots/pde_most_differential_genes_tables.txt
pde_plot_most_differential_genes_violin_plots	true:plot:optional	pde/plots/pde_most_differential_genes_violin_plots.txt
pde_plot_spatial_enrichment_table	true:plot:spatial	pde/plots/pde_spatial_enrichment_table.txt
pde_plot_spatial_enrichment_distribution_plots	true:plot:spatial	pde/plots/pde_spatial_enrichment_distribution_plots.txt
pde_plot_hypergeometric_enriched_gene_sets_barchart	true:plot:hypergeometric_gene_set	pde/plots/pde_hypergeometric_enriched_gene_sets_barcharts.txt
pde_plot_hypergeometric_enriched_gene_sets_boxplots	true:plot:hypergeometric_gene_set	pde/plots/pde_hypergeometric_enriched_gene_sets_boxplots.txt
pde_plot_hypergeometric_enriched_gene_sets_network_plots	true:plot:hypergeometric_gene_set	pde/plots/pde_hypergeometric_enriched_gene_sets_network_plots.txt
pde_plot_hypergeometric_underenriched_gene_barcharts	true:plot:hypergeometric_gene_set	pde/plots/pde_hypergeometric_underenriched_gene_sets_barcharts.txt
pde_plot_upstream_regulator_barcharts	true:plot:ipa_ureg	pde/plots/pde_ipa_upstream_regulators_barcharts.txt
pde_plot_upstream_regulator_boxplots	true:plot:ipa_ureg	pde/plots/pde_ipa_upstream_regulators_boxplots.txt
pde_plot_upstream_regulator_network_plots	true:plot:ipa_ureg	pde/plots/pde_ipa_upstream_regulators_network_plots.txt
pde_end_plots	true:plot_core:core	none
pde_run_r	true:plot_core:core	none

pde_start_report	true:report_core:core	none
pde_report_expression	true:report_title:optional	Expression
pde_report_distribution_of_expression_values	true:report_plot:optional	pde/report/pde_distribution_of_expression_values.txt
pde_report_PCA_contribution_of_components	true:report_plot:optional	pde/report/pde_PCA_contributions_of_components.txt
pde_report_PCA_scatterplot	true:report_plot:optional	pde/report/pde_PCA_scatterplot.txt
pde_report_correlation_analysis_heatmap	true:report_plot:optional	pde/report/pde_correlation_analysis_heatmap.txt
pde_report_most_expressed_genes_tables	true:report_plot:optional	pde/report/pde_most_expressed_genes_tables.txt
pde_report_most_expressed_genes_violin_plots	true:report_plot:optional	pde/report/pde_most_expressed_genes_violin_plots.txt
pde_report_differential_expression	true:report_title:optional	Differential Expression
pde_report_volcano_plot	true:report_plot:optional	pde/report/pde_volcano_plot.txt
pde_report_MA_plot	true:report_plot:optional	pde/report/pde_MA_plot.txt
pde_report_number_of_significant_genes	true:report_plot:optional	pde/report/pde_number_of_significant_genes.txt
pde_report_significant_genes_heatmap	true:report_plot:optional	pde/report/pde_significant_genes_heatmap.txt
pde_report_most_differential_genes_tables	true:report_plot:optional	pde/report/pde_most_differential_genes_tables.txt
pde_report_most_differential_genes_violin_plots	true:report_plot:optional	pde/report/pde_most_differential_genes_violin_plots.txt
pde_spatial_enrichment	true:report_title:spatial	Spatial Analysis
pde_spatial_enrichment_table	true:report_plot:spatial	pde/report/pde_spatial_enrichment_table.txt
pde_spatial_enrichment_distribution_plots	true:report_plot:spatial	pde/report/pde_spatial_enrichment_distribution_plots.txt
pde_report_hypergeometric_gene_sets	true:report_title:hypergeometric_gene_set	Hypergeometric Gene Set Enrichment
pde_report_hypergeometric_enriched_gene_sets_barcharts	true:report_plot:hypergeometric_gene_set	pde/report/pde_hypergeometric_enriched_gene_sets_barcharts.txt
pde_report_hypergeometric_enriched_gene_sets_boxplots	true:report_plot:hypergeometric_gene_set	pde/report/pde_hypergeometric_enriched_gene_sets_boxplots.txt
pde_report_hypergeometric_enriched_gene_sets_network_plots	true:report_plot:hypergeometric_gene_set	pde/report/pde_hypergeometric_enriched_gene_sets_network_plots.txt
pde_report_hypergeometric_underenriched_gene_barcharts	true:report_plot:hypergeometric_gene_set	pde/report/pde_hypergeometric_underenriched_gene_sets_barcharts.txt
pde_report_upstream_regulators	true:report_title:ipa_ureg	Upstream Regulators
pde_report_upstream_regulator_barcharts	true:report_plot:ipa_ureg	pde/report/pde_ipa_upstream_regulators_barcharts.txt
pde_report_upstream_regulator_boxplots	true:report_plot:ipa_ureg	pde/report/pde_ipa_upstream_regulators_boxplots.txt
pde_report_upstream_regulator_network_plots	true:report_plot:ipa_ureg	pde/report/pde_ipa_upstream_regulators_network_plots.txt
pde_report_methodology	true:report_title:optional	Methodology
pde_report_core_workflow_methods	true:report_text:optional	methods/pde/core_workflow.txt
pde_report_spatial_analysis_methods	true:report_text:optional	methods/pde/spatial_analysis.txt
pde_report_hypergeometric_gene_set_enrichment_methods	true:report_text:hypergeometric_gene_set	methods/pde/hypergeometric_gene_set_enrichment.txt
pde_report_upstream_regulators_methods	true:report_text:ipa_ureg	methods/pde/upstream_regulators.txt
pde_report_extras	true:report_title:optional	Extras
pde_report_citation	true:report_text:optional	citation.txt
pde_end_report	true:report_core:core	none

##---- mpde ----##
mpde_sub_directories_core	true:core:directory	none

mpde_file_all_genes_IDs	true:core:file	none
mpde_file_genes_significant_in_any_comparison_IDs	true:core:file	none
mpde_file_genes_significant_in_all_comparisons_IDs	true:core:file	none
mpde_file_all_genes_symbols	true:core:file	none
mpde_file_genes_significant_in_any_comparison_symbols	true:core:file	none
mpde_file_genes_significant_in_all_comparisons_symbols	true:core:file	none
mpde_file_all_genes_annotated	true:core:file	none
mpde_file_genes_significant_in_any_comparison_annotated	true:core:file	none
mpde_file_genes_significant_in_all_comparisons_annotated	true:core:file	none

mpde_analysis_pairwise_overlap	true:statistical:pairwise_overlap	none
mpde_differential_expression_signature	true:statistical:differential_expression_signature	none

mpde_start_plots	true:plot_core:core	none
mpde_plot_distribution_of_expression_values	true:plot:optional	mpde/plots/mpde_distribution_of_expression_values.txt
mpde_plot_PCA_contribution_of_components	true:plot:optional	mpde/plots/mpde_PCA_contributions_of_components.txt
mpde_plot_PCA_scatterplot	true:plot:optional	mpde/plots/mpde_PCA_scatterplot.txt
mpde_plot_correlation_analysis_heatmap	true:plot:optional	mpde/plots/mpde_correlation_analysis_heatmap.txt
mpde_plot_most_expressed_genes_tables	true:plot:optional	mpde/plots/mpde_most_expressed_genes_tables.txt
mpde_plot_most_expressed_genes_violin_plots	true:plot:optional	mpde/plots/mpde_most_expressed_genes_violin_plots.txt
mpde_plot_number_of_significant_genes	true:plot:optional	mpde/plots/mpde_number_of_significant_genes.txt
mpde_plot_significant_genes_heatmap	true:plot:optional	mpde/plots/mpde_significant_genes_heatmap.txt
mpde_plot_pairwise_overlap_table	true:plot:optional	mpde/plots/mpde_pairwise_overlap_table.txt
mpde_plot_fold_vs_fold_scatterplot	true:plot:optional	mpde/plots/mpde_fold_vs_fold_scatterplots.txt
mpde_plot_differential_expression_signatures_metagene_violin_plots	true:plot:optional	mpde/plots/mpde_differential_expression_signature_metagene_violin_plot.txt
mpde_plot_differential_expression_signatures_heatmap	true:plot:optional	mpde/plots/mpde_differential_expression_signatures_heatmap.txt
mpde_plot_differential_expression_signatures_hypergeometric_gene_sets_barcharts	true:plot:hypergeometric_gene_set	mpde/plots/mpde_differential_expression_signatures_hypergeometric_gene_sets_barchart.txt
mpde_end_plots	true:plot_core:core	none
mpde_run_r	true:plot_core:core	none

mpde_start_report	true:report_core:core	none
mpde_report_expression	true:report_title:optional	Expression
mpde_report_distribution_of_expression_values	true:report_plot:optional	mpde/report/mpde_distribution_of_expression_values.txt
mpde_report_PCA_contribution_of_components	true:report_plot:optional	mpde/report/mpde_PCA_contributions_of_components.txt
mpde_report_PCA_scatterplot	true:report_plot:optional	mpde/report/mpde_PCA_scatterplot.txt
mpde_report_correlation_analysis_heatmap	true:report_plot:optional	mpde/report/mpde_correlation_analysis_heatmap.txt
mpde_report_most_expressed_genes_tables	true:report_plot:optional	mpde/report/mpde_most_expressed_genes_tables.txt
mpde_report_most_expressed_genes_violin_plots	true:report_plot:optional	mpde/report/mpde_most_expressed_genes_violin_plots.txt
mpde_report_multiple_differential_expression	true:report_title:optional	Multiple Differential Expression
mpde_report_number_of_significant_genes	true:report_plot:optional	mpde/report/mpde_number_of_significant_genes.txt
mpde_report_significant_genes_heatmap	true:report_plot:optional	mpde/report/mpde_significant_genes_heatmap.txt
mpde_report_pairwise_overlap_table	true:report_plot:optional	mpde/report/mpde_pairwise_overlap_table.txt
mpde_report_fold_vs_fold_scatterplot	true:report_plot:optional	mpde/report/mpde_fold_vs_fold_scatterplots.txt
mpde_report_differential_expression_signatures	true:report_title:optional	Differential Expression Signatures
mpde_report_differential_expression_signatures_metagene_violin_plots	true:report_plot:optional	mpde/report/mpde_differential_expression_signatures_metagene_violin_plot.txt
mpde_report_differential_expression_signatures_heatmap	true:report_plot:optional	mpde/report/mpde_differential_expression_signatures_heatmap.txt
mpde_report_differential_expression_signatures_hypergeometric_gene_sets_barcharts	true:report_plot:hypergeometric_gene_set	mpde/report/mpde_differential_expression_signatures_hypergeometric_gene_sets_barchart.txt
mpde_report_methodology	true:report_title:optional	Methodology
mpde_report_core_workflow_methods	true:report_text:optional	methods/mpde/core_workflow.txt
mpde_report_differential_expression_signatures_methods	true:report_text:optional	methods/mpde/differential_expression_signatures.txt
mpde_report_hypergeometric_gene_set_enrichment_analysis_methods	true:report_text:hypergeometric_gene_set	methods/mpde/hypergeometric_gene_set_enrichment_analysis.txt
mpde_report_extras	true:report_title:optional	Extras
mpde_report_citation	true:report_text:optional	citation.txt
mpde_end_report	true:report_core:core	none
